11111111111111111111
11111111111111111111
11111111111111111111
11111111111111111111
11111000000000111111
11111111111111111111
11111111111111111111
11111111111111111111
11111100000001111111
11111100000001111111
11111100000001111111
11111100000001111111
11111111111111111111
11111111111111111111
11111111111111111111
11111111111111111111
11111111111111111111
11111111111111111111
11111111111111111111
11111111111111111111