11111111111111111111
11111111111111111111
11111111111111111111
11110000111111111111
11110111111111111111
11110111111111111111
11110111111111111111
11110111111111111111
11111111000011111111
11111111000011111111
11111111000011111111
11111111000011111111
11111111111111111111
11111111111111111111
11111111111111111111
11111111111111111111
11111111111111111111
11111111111111111111
11111111111111111111
11111111111111111111